git am             -->  Apply a series of patches from a mailbox.
git archive        -->  Create an archive of files from a named tree.
git bisect         -->  Use binary search to find the commit that introduced a bug.
git bundle         -->  Move objects and refs by archive.
git cherry-pick    -->  Apply the changes introduced by some existing commits.
git citool         -->  Graphical alternative to git-commit.
git clean          -->  Remove untracked files from the working tree.
git describe       -->  Give an object a human readable name based on an available ref.
git fetch          -->  Download objects and refs from another repository.
git format-patch   -->  Prepare patches for e-mail submission.
git gc             -->  Cleanup unnecessary files and optimize the local repository.
git grep           -->  Print lines matching a pattern.
git gui            -->  A portable graphical interface to Git.
git mv             -->  Move or rename a file, a directory, or a symlink.
git notes          -->  Add or inspect object notes.
git rebase         -->  Reapply commits on top of another base tip.
git reset          -->  Reset current HEAD to the specified state. 
git restore        -->  Restore working tree files.
git revert         -->  Revert some existing commits.
git rm             -->  Remove files from the working tree and from the index.
git shortlog       -->  Summarize git log output.
git show           -->  Show various types of objects.
git stash          -->  Stash the changes in a dirty working directory away.
git submodule      -->  Initialize, update or inspect submodules.
git switch         -->  Switch branches.
git worktree       -->  Manage multiple working trees.
git config         -->  Get and set repository or global options.
git fast-export    -->  Git data exporter.
git fast-import    -->  Backend for fast Git data importers.
git filter-branch  -->  Rewrite branches.
git mergetool      -->  Run merge conflict resolution tools to resolve merge conflicts.
git 
